uuuuuuuuuuuuuuuuuuuuuuuuuuuuuu
000000011000000000000000000000
000000010100000000000000000000
000000010010000000000000000000
000000010000000000000000000000
000000011111110000000000000000
0000000011111100000u0000000000
000000001111110000000000000000
000000001111110000000000000100
000000001111110000000000000100
000000001100110000000000000100
000000000000000000000000000000
000000000000000000000000000000
000000000000000000000000010000
000000000000000000000000000000
jjjjjjjjjjjjjjjjjjjjjjjjjjjjjj
