h0000000000000000000000000000k
h0000000000000000000000000000k
h0000000000000000001110000000k
h0000000000000000001010000000k
h1111111111111000001110000000k
h0000000111111000000000000000k
h0000000111111000000000000000k
h0000000111111000000000000000k
h0000000111111000000000000000k
h0000000111111000000000000000k
h000000011001100000@000000000k
h0000000110011000000000000000k
h0000000110011000000000000000k
h0000000000000000000000000000k
h0000000000000000000000000000k
h0000000000000000000000000000k