110000000000000000000110000000
000000000000001100000110000011
000000000000001100000000000011
000000000000001100000000011011
0000@0000000000000000000011011
000000000000000000000000011000
000000000000000000000000000000
000000001111110000000000000000
000000001111110000000000000000
000000001111110000000000000000
000000001101110000000000000000
000000000000000000000000000000
000000000000000000000000000000
000000000000000000000000000000
000000000000000000000000000000
000000000000000000000000000000
111100000000000000000000001111
111100000000000000000000001111
111100000000000000000000001111
111100000000000000000000001111
111100000000000000000000001111
111100000000000000000000001111
111100000000000000000000001111